100 . # X
.................................#.....................#......#......#................#........#....
.............#......#....#......................#.#..........#........#...#....#.......#.#.....#....
............#....................#...............#...............................#.#................
........##.....#..................#........................##...................#...#..#.#........#.
#.............#.................#...#.....#......#.....................#.##..#...............#......
..........#.........#...............#...#........................................#........#...##....
.........#...#..#...............#........#..#......................##....#..#................#......
............................#...........................#.#.........#...............................
.............................................#....#.#......#.....................#.........##.#.....
.#.#.#.......#.........#...........#....#................#...#............#...#.....................
..#............#...........................................#.......#..........#............#..#.##.#
.....#...#...................##.....#.................................#......#......#.#.............
#...#.....##..........#..#......#...##......#.............#........#...#.....#....#.#...............
...##.....#..............................#.........#.#.#...........................#................
.......#......#.........#...#...#...#.....#...#........###.....................#.......#............
..................................#.#...........................#..........#........................
.......#.......#.............................#.........#....#.............................##.......#
##...........#..........................#.............#.............#...............#...............
........................#.......#..#......#......................#.................#........#.#.#...
..........#........#..........##.#.......#...............#..#...............#.#.....#...........#...
......#...#..#....##.....#......#..........................#......#..#..........#.............#.....
#............##................................................................##...........#.......
....#.......................#.........#...................#......#...............#............#....#
.......................#............###......#....................#..............#...............##.
..#......#.#.....#...#.....#...........##....................#.......................#...##.#.......
.........................#.#...#............#......................#........#.#.#...................
.#....#...#.............................................#.......#.....#.......#.....................
....#...#..#....##..........#...#..#.#...#........#.#..#........#..........##.............#...##..#.
....##.....#.............#...#...#..#...#...#..........................#.#........#.................
...........#.......#...#.....#.#...........#........#..............##..#.........#.........#........
..........#....#...#....................#.........#.................#...............................
...#.............#..........#........#.......#..#.............#..........#......#........#..........
...........................#.........................................#..................#...........
...........#...#...#...#.................#.#...#........##.#...................#.............#......
#............#...#....#..............##...#...................#.......#...............#.............
..............#........#.#.....................#.#.......#.....#...........#......#.....#......#....
.#..#........##....#............#..........#...........#.....................................#......
.....#..........###.....#......................................#.#...#................#.............
.......#..#.......#...##......................#...#...#...........................#..#...........#..
..........#.........#....#.#................#..........#..#......................##.....#..#.....#..
................#........................#.........##.#.............................................
.....#..##.........................#............#.............##..............#...##......#.....#...
.......#.................#.........................................#.........#...##.#........#......
......#..#............#..................#......#..........#...............#.......#..#.....#.....#.
...#...#........#....#........#...................................##..........#.....#.##.......#....
..........#.##.......................#..................#...#.......#..#............................
................#......................##......#..........#............#......#.............#...#...
..........#...........#..#.........#..............#............#..#...............................#.
.#...............#.......................#......#..................................#................
#.....#.......................#.....#............................#.#.............#.#...#.......#....
.........#...................#...#...............................##........#........#...............
.....#......#................##.#.......#..#.........#.....#........#..#..........................#.
......................#...##..#..............#..........................#.....................#..##.
........#.#.............#...#.#...............#...............#.....................................
..#...................................#.#.................##.............##...............#........#
.....#................................#....#..........#.........#.....#.........#..........#........
#...#..........#.#.#............................................#.........#.........................
..............#..........................#..#...............#...#.....#........#.....#..##..........
..........#.....#...........#..............#.........#......#......##............#...#.#....#.......
......##.......#...............#.....#...............#..................#..#..#....###......#...#..#
...##..................................................#..#.......#..............#...............#..
.......#..#...............##.............#..#...............#...............#...#..#................
...#.#.............................#.....................#..........................................
......#.......#...#................##...#...................#...........................#...........
.......#.....#......#......#.....#.........................#............#............#...........#..
.......#..#.#...#.#........#....#....................#.......................#........###.#.........
...#.........#.....#.....#.....#..#.......#.......#......#.................#...#..#.......#....#....
...#..#.....#........#.....................#.#..............#...........#.................#..#.....#
................#......#...........#...#..........#.............#.#........#......#.........#.......
.............#.#..............#........#.......#...#......#...#...............#......#.......#....#.
....#....#...........................#....#..#.#..............#...#............#...............#...#
.......................#.....#...#...#....................#...#.....##..............#.....#.........
......#................................#......................#....#...........................#....
#....#.........#...#..............................#......#................#....................#....
#....#........#...............................#..##..#..........................#.........##...#....
................#.............#....#.........#...............................#...............#......
......#...#.....#....#......#...............#........#...........#............#..................#..
.....#....##............#.......#..#..#.....#.....##..................#....#.................#.....#
..........#.........#.#............#....###........#................#.....................#...#.....
..............#.........#........#................#............#..............#..#..#...............
........#...#........#....#......##.........#.................#........#.........#....#.......#.....
.........#........##............#.#........#.........##..##.......................#.................
...............#.......#..#..#........#...#..#..#..##.......#....#.................#...#............
##............#..#....#..........#...........#...#....#......................................#......
........#......##...................................##.#.....#.#..........#.....#.#...........#.#...
..................................................#..........#........#..........##......#.......#..
....#...#................................#..#....#.........#....#...........#.......................
#..........##..#.........#......................#.........#........#.......#........#....#........#.
.......#.......#..#.#....#........#.........................#.................#....#..#..#..........
......................#..........#.#.......#...............#.........#............#.......#.#.......
...................#..........#........#..............................#.#.....##............#...#.#.
.......##..........#............................#.........#............#..........#.................
..........##.#........#......#...........#.............#..#...........##..#........................#
..................#........#....#.....................#....#..........#.......#.#.##...........#..#.
...#.#...............................#........................#......#.............#................
....##.......#...........#.....#.#........#..........#..................#....#.............#..#.....
......#............#...#............#.........#..........................#........##..##............
#....................................#................##..........#.#...................#...........
..#....#.....#...#.##.#......#..............#..#............#............#...........#.......#....#.
....#...........#...#.........#....................#..........#...............#........#............
