12 . # X
............
.###........
....#.......
............
........####
............
.......#....
............
............
############
............
............
